11111111111111111111111
1E0001C00000000C00000C1
11100100001100001010011
10000100101100111110011
1P0000000C00C0100C00001
10000C00000000000000001
10000100000001000C00001
1000C100C00011100000001
11111111111111111111111