1111111111111111111111
1E0M0000000000000000C1
1000011111111111110001
1001010000000000C10001
1001010111111111010001
10010101C000000101C001
1001010101111101010001
1001010101CP01C1010001
1001010101110101010001
100101010C000101010001
10010101111111010100M1
1001010000000001010C01
1M01011111111111010001
1001C00000000000010001
1001111111111111110001
100000000C000000000001
1111111111111111111111